%%%%%%%%%%%%%%%%%%%%%%%%%%%%%%%%%%%%%
%                                   %
%                       %%%%%%%%%   %
%                       %       %   %
%                       %--- -%+%   %
%                       %     %%%   %
%                       %           %
%                       %           %
%                       %           %
%                       %           %
%                       % -         %
%                       %           %
%     %%%%%%%%%%%%%%%%%%%           %
%                                   %
%                                   %
%                                   %
%     %%%%%%%%%%                    %
%              %                    %
%              %                    %
%%%%%%%%%%%%%%%%%%%%%%%%%%%%%%%%%%%%%
